0 9 9 9 0 0 0 0 0 0 0 0 0 0 0 0
0 0 0 0 0 9 0 9 0 0 0 0 0 0 0 0
0 0 0 0 1 0 0 0 1 0 0 0 0 9 0 0
2 2 0 1 0 0 6 0 0 1 0 0 0 9 9 9
5 5 0 1 0 0 4 0 0 1 0 0 0 0 0 0
1 1 0 0 1 0 0 0 1 0 0 2 2 2 2 0
1 1 0 0 0 1 1 1 0 0 0 5 3 5 5 0
0 0 0 0 0 0 0 0 0 0 0 1 1 1 1 0
0 0 0 0 0 0 0 0 0 0 0 9 0 0 0 0
12,8
<Lamp>
15,2
0,1
0,8
10,8
</Lamp>
<Door>
6,5
</Door>
<Enemy>
1,1
6,7
</Enemy>
<Spawn>
2,4 660 10000 2222555574744477
6,7 600 10000 44444475555552
6,5 10000 400 0
11,2 500 10000 25777555777222444224
</Spawn>
<Event>
</Event>