5 5 5 0 0 1 5 6 5 1 0 0 0 5 5 5
1 3 1 0 0 0 1 4 1 0 0 0 0 1 1 1
1 1 1 0 0 9 0 0 0 9 0 0 0 1 1 1
0 0 0 0 0 0 0 0 0 0 0 0 0 0 0 9
0 0 0 9 0 0 0 0 0 0 0 9 0 0 0 0
0 0 0 0 0 0 0 0 0 0 0 0 0 0 0 0
2 2 2 0 0 9 9 9 9 9 0 0 9 9 9 0
5 5 5 0 0 0 0 0 0 0 0 0 9 0 0 0
1 3 1 0 0 0 0 0 0 0 0 0 9 0 0 0
7,4
<Lamp>
0,3
5,7
9,7
13,3
13,7
</Lamp>
<Door>
7,2
</Door>
<Enemy>
0,3
3,8
7,8
11,8
13,7
</Enemy>
<Spawn>
4,0 500 1000 777555555222777444444222
15,8 4000 600 0
</Spawn>
<Event>
</Event>