5 5 0 2 2 2 2 2 2 2 2 0 1 2 2 2
3 1 0 5 5 5 5 5 5 5 5 0 0 2 2 2
1 1 0 1 3 1 3 1 0 1 1 1 0 5 5 5
0 0 0 1 1 6 1 1 0 1 1 0 0 0 1 3
2 2 0 1 1 4 1 1 0 1 1 0 9 0 1 1
2 2 0 9 9 0 0 0 0 0 0 0 9 0 1 1
5 5 0 0 0 0 0 0 0 0 0 0 9 0 0 0
3 1 0 2 2 0 0 0 0 0 9 9 9 0 0 0
1 1 0 2 2 0 2 2 2 2 2 2 2 0 0 0
5,8
<Lamp>
0,3
15,6
8,2
</Lamp>
<Door>
5,5
</Door>
<Enemy>
2,2
11,0
15,7
9,7
</Enemy>
<Spawn>
2,0 300 1500 7777777722222222
</Spawn>
