0 0 0 0 0 0 0 0 0 0 0 0 0 0 0 0
0 0 0 0 9 9 9 9 0 0 0 0 0 0 0 0
0 0 0 0 9 0 0 0 0 0 0 0 0 0 0 0
0 0 0 0 9 9 9 9 0 0 0 0 0 0 0 0
0 0 0 0 0 0 0 9 9 0 0 0 0 0 0 0
0 0 0 0 0 0 0 0 9 0 0 0 0 0 0 0
0 0 0 0 9 0 0 9 9 0 0 0 0 0 0 0
0 0 0 0 9 9 9 9 0 0 0 0 0 0 0 0
0 0 0 0 0 0 0 0 0 0 0 0 0 0 0 0
15,6
<Lamp>
14,6
</Lamp>
<Door>
15,5
</Door>
<Enemy>
</Enemy>
<Spawn>
0,1 35 150 555
0,2 34 1500 555
0,3 25 1500 555
0,4 15 1500 555
0,5 25 1500 555
0,6 34 1500 555
0,7 35 150 555
</Spawn>
<Event>
</Event>